11111111111111
10P000000000C1
10000000100001
10000000000001
101E00000C0001
11111111111111
