11111111111111
11P000000000C1
10100000100011
10010000000011
101E0000000101
11111111111111
