11111111111
100P0000001
10000000C01
10000000001
100C000E001
11111111111
